15 80
______________________#_________________________________________________________
______________________#_________________________________________________________
______________________#_________________________________________________________
______________________#_________________________________________________________
###___________________#_________________________________________________________
___#__________________#_________________________________________________________
______________________#_________________________________________________________
_____#________________#_________________________________________________________
____________#######____$$_______________________________________________________
_______C___________#____________________________________________________________
________________________________________________________________________________
2____##+##_________###$##_______________________________________________________
#_________________##____________________________________________________________
#_______3________###__3_______________________________________________________0_
################################################################################